#####
#C.##
##.C#
###.#
#C..#
#####
